8,8,8,8,8,8,8,8,8,8,8,8,8,8,8,8, , , ,8,8,8,8,8,8,8,8,8,8,8,8,8,8,8,8,8,8,8,8,8,8,8,8,8,8,8,8,8
8,_,_,_,_,_,_,_,E,_,_,_,_,_,_,8, , , ,8,_,_,_,_,L,_,_,_,_,_,_,_,L,_,_,_,_,_,_,_,L,_,_,_,_,_,_,8
8,_,_,_,_,_,_,_,_,_,_,_,_,_,_,8, , , ,8,_,_,_,_,L,_,_,_,_,_,_,_,L,_,_,_,_,_,_,_,L,_,_,_,_,_,_,8
8,_,_,_,_,_,_,_,_,_,_,_,_,_,_,8,8,8,8,8,_,_,_,_,L,_,_,_,_,_,_,_,L,_,_,_,_,_,_,_,L,_,_,_,_,_,_,8
8,_,_,_,_,_,_,_,_,_,_,_,_,_,_,_,_,_,_,_,_,_,_,_,L,_,_,_,_,_,_,_,L,_,_,_,_,_,_,_,L,_,_,_,_,_,_,8
8,_,_,_,_,_,_,_,_,_,_,_,_,_,_,_,_,_,_,_,_,_,_,_,L,_,_,_,L,_,_,_,L,_,_,_,L,_,_,_,L,_,_,_,_,_,_,8
8,_,_,_,_,_,_,_,_,_,_,_,_,_,_,8,8,8,8,8,_,_,_,_,L,_,_,_,L,_,_,_,L,_,_,_,L,_,_,_,L,_,_,_,_,_,_,8
8,_,_,_,_,_,_,_,_,_,_,_,_,_,_,8, , , ,8,_,_,_,_,_,_,_,_,L,_,_,_,_,_,_,_,L,_,_,_,_,_,_,_,_,_,_,8
8,_,_,_,_,_,_,_,_,_,_,_,_,_,_,8, , , ,8,_,_,_,_,_,_,_,_,L,_,_,_,_,_,_,_,L,_,_,_,_,_,_,_,_,_,_,8
8,8,8,8,8,8,8,_,_,8,8,8,8,8,8,8, , , ,8,_,_,_,_,_,_,_,_,L,_,_,_,_,_,_,_,L,_,_,_,_,_,_,_,_,_,_,8
 , , , , , ,8,_,_,8, , , , , , , , , ,8,_,_,_,_,_,_,_,_,L,_,_,_,_,_,_,_,L,_,_,_,_,_,_,_,_,_,_,8
 , , , , , ,8,_,_,8, , , , , , , , , ,8,8,8,8,8,8,8,8,8,8,8,8,8,8,8,8,8,8,8,8,8,8,8,8,8,8,8,8,8
 , , , , , ,8,_,_,8, , , , , , , , , , , , , , , , , , , , , , , , , , , , , , , , , , , , , , 
 , , , , , ,8,_,_,8, , , , , , , , , , , , , , , , , , , , , , , , , , , , , , , , , , , , , , 
 , ,8,8,8,8,8,_,_,8,8,8,8,8,8,8,8,8,8,8,8,8,8,8,8,8,8,8,8,8, , , , , , , , , , , , , , , , , , 
 , ,8,_,_,_,_,_,_,_,_,_,_,_,_,_,_,_,_,_,_,_,_,_,_,_,_,_,_,8, , , ,8,8,8,8,8,8,8,8,8, , , , , , 
 , ,8,_,_,_,_,_,_,_,_,_,8,8,_,_,_,_,_,_,_,_,L,L,L,_,_,_,_,8, , , ,8,_,_,E,E,E,_,_,8, , , , , , 
 , ,8,_,_,_,L,L,L,L,_,_,8,8,_,_,_,_,_,_,_,_,L,L,L,_,_,_,_,8,8,8,8,8,_,_,E,E,E,_,_,8, , , , , , 
 , ,8,_,_,_,L,L,L,L,_,_,_,_,_,_,_,_,_,_,_,_,_,_,_,_,_,_,_,_,_,_,_,_,_,_,_,_,_,_,_,8, , , , , , 
 , ,8,_,_,_,_,_,_,_,_,_,_,_,L,L,L,L,_,_,_,_,_,_,_,_,_,_,_,_,_,_,_,_,_,_,_,_,_,_,_,8, , , , , , 
 , ,8,_,_,_,_,_,_,_,_,_,_,_,L,L,L,L,_,_,_,_,_,_,_,_,_,_,_,8,8,8,8,8,_,_,_,_,_,_,_,8, , , , , , 
 , ,8,_,_,_,_,_,_,_,_,_,_,_,_,_,_,_,_,_,_,_,_,_,_,_,_,_,_,8, , , ,8,_,_,L,L,L,_,_,8, , , , , , 
 , ,8,8,8,8,8,8,8,8,8,8,8,8,8,8,8,8,8,8,8,8,8,8,8,8,8,8,8,8, , , ,8,8,8,8,8,8,8,8,8, , , , , , 
 , , , , , , , , , , , , , , , , , , , , , , , , , , , , , , , , , , , , , , , , , , , , , , ,