8,8,8,8,8,8,8,8,8,8,8,8,8,8,8,8,8,8,8,8,8,8,8,8,8,8,8,8,8,8,8,8, , , , , , , , , , , , , , , , 
8,_,_,_,_,_,_,_,_,_,_,_,_,_,_,_,_,_,_,_,_,_,_,_,_,_,_,_,_,_,_,8, , , , , , , , , , , , , , , 
8,_,L,L,_,_,_,_,_,_,_,_,_,_,_,_,_,_,_,_,_,_,_,_,_,_,_,_,_,_,_,8, , , , , , , , , , , , , , , , 
8,_,L,_,_,_,_,_,E,_,_,_,_,_,_,_,_,_,_,_,_,_,_,_,_,_,_,_,_,_,_,8, , , , , , , , , , , , , , , , 
8,_,_,_,_,_,_,_,_,_,_,_,_,_,_,_,_,_,_,_,_,_,_,_,_,_,_,_,_,_,_,8, , , , , , , , , , , , , , , , 
8,_,_,_,_,_,_,_,_,_,_,_,_,_,_,_,_,_,_,_,_,_,_,_,_,_,_,_,_,_,_,8,8,8,8,8,8,8,8,8,8,8,8,8,8,8,8,8
8,_,_,_,_,_,_,_,_,_,_,_,_,_,_,_,_,_,_,_,_,_,_,_,_,_,_,_,_,_,_,_,_,_,_,_,_,_,_,_,_,_,_,_,_,_,_,8
8,_,_,_,_,_,_,_,_,_,_,_,_,_,_,_,_,_,_,_,_,_,_,_,_,_,_,_,_,_,_,_,_,_,_,_,_,_,_,_,_,_,_,_,_,_,_,8
8,_,_,_,_,_,_,_,_,_,_,_,_,_,_,_,_,_,_,_,_,_,_,_,_,_,_,_,_,_,_,_,_,_,_,_,_,_,_,_,_,_,_,_,_,_,_,8
8,_,_,_,_,_,_,_,_,_,_,_,_,_,_,_,_,_,_,_,_,_,_,_,_,_,_,_,_,_,_,8,8,8,8,8,8,8,8,8,8,8,8,8,8,8,8,8
8,_,_,_,_,_,_,_,_,_,_,_,_,_,_,_,_,_,_,_,_,_,_,_,_,_,_,_,_,_,_,8, , , , , , , , , , , , , , , , 
8,_,_,_,_,_,_,_,_,_,_,_,_,_,_,_,_,_,_,_,_,_,_,_,_,_,_,_,_,_,_,8, , , , , , , , , , , , , , , , 
8,_,_,_,_,_,_,_,_,_,_,_,_,_,_,_,_,_,_,_,_,_,_,_,_,_,_,_,_,_,_,8, , , , , , , , , , , , , , , , 
8,_,_,_,_,_,_,_,_,_,_,_,_,_,_,_,_,_,_,_,_,_,_,_,_,_,_,_,_,_,_,8, , , , , , , , , , , , , , , , 
8,_,_,_,_,_,_,_,_,_,_,_,_,_,_,_,_,_,_,_,_,_,_,_,_,_,_,_,_,_,_,8, , , , , , , , , , , , , , , , 
8,_,_,_,_,_,_,_,_,_,_,_,_,_,_,_,_,_,_,_,_,_,_,_,_,_,_,_,_,_,_,8, , , , , , , , , , , , , , , , 
8,_,_,_,_,_,_,_,_,_,_,_,_,_,_,_,_,_,_,_,_,_,_,_,_,_,_,_,_,_,_,8, , , , , , , , , , , , , , , , 
8,8,8,8,8,8,8,8,8,8,8,_,_,_,8,8,8,8,8,8,8,8,8,8,8,8,8,8,8,8,8,8, , , , , , , , , , , , , , , , 
 , , , , , , , , ,8,_,_,_,_,_,8, , , , , , , , , , , , , , , , , , , , , , , , , , , , , , , , 
 , , , , , , , , ,8,_,_,_,_,_,8, , , , , , , , , , , , , , , , , , , , , , , , , , , , , , , , 
 , , , , , , , , ,8,8,_,_,_,8,8, , , , , , , , , , , , , , , , , , , , , , , , , , , , , , , , 
 , , , , , , , , , ,8,8,8,8,8, , , , , , , , , , , , , , , , , , , , , , , , , , , , , , , , , 